Rk,Player,Pos,Age,Tm,G,GS,MP,FG,FGA,FG%,3P,3PA,3P%,2P,2PA,2P%,eFG%,FT,FTA,FT%,ORB,DRB,TRB,AST,STL,BLK,TOV,PF,PTS
1,Jaylen Adams\adamsja01,PG,24,MIL,7,0,18,1,8,0.125,0,2,0.0,1,6,0.16666666666666666,0.125,0,0,nan,0,3,3,2,0,0,0,1,2
15,Cole Anthony\anthoco01,PG,20,ORL,47,34,1273,219,552,0.3967391304347826,58,172,0.3372093023255814,161,380,0.4236842105263158,0.4492753623188406,109,131,0.8320610687022901,38,183,221,192,30,18,106,98,605
17,Ryan Arcidiacono\arcidry01,PG,26,CHI,44,0,450,49,117,0.4188034188034188,25,67,0.373134328358209,24,50,0.48,0.5256410256410257,13,20,0.65,5,62,67,56,9,0,10,47,136
19,D.J. Augustin\augusdj01,PG,33,TOT,114,24,2258,270,686,0.3935860058309038,166,434,0.3824884792626728,104,252,0.4126984126984127,0.5145772594752187,170,188,0.9042553191489362,40,148,188,376,56,2,130,112,876
25,LaMelo Ball\ballla01,PG,19,CHO,51,31,1469,293,672,0.43601190476190477,92,261,0.3524904214559387,201,411,0.48905109489051096,0.5044642857142857,125,165,0.7575757575757576,63,239,302,313,81,18,145,136,803
26,Lonzo Ball\balllo01,PG,23,NOP,55,55,1747,290,700,0.4142857142857143,172,455,0.378021978021978,118,245,0.4816326530612245,0.5371428571428571,50,64,0.78125,33,230,263,316,82,31,123,103,802
42,Patrick Beverley\beverpa01,PG,32,LAC,37,34,832,93,220,0.42272727272727273,56,141,0.3971631205673759,37,79,0.46835443037974683,0.55,36,45,0.8,29,90,119,76,29,28,34,108,278
55,Jordan Bone\bonejo01,PG,23,ORL,14,0,196,23,54,0.42592592592592593,10,32,0.3125,13,22,0.5909090909090909,0.5185185185185185,0,0,nan,4,20,24,18,2,0,3,11,56
68,Malcolm Brogdon\brogdma01,PG,28,IND,56,56,1930,444,980,0.4530612244897959,145,374,0.3877005347593583,299,606,0.4933993399339934,0.5270408163265307,153,177,0.864406779661017,58,236,294,329,49,15,115,110,1186
71,Bruce Brown\brownbr01,PG,24,BRK,65,37,1451,235,423,0.5555555555555556,17,59,0.288135593220339,218,364,0.5989010989010989,0.5756501182033097,86,117,0.7350427350427351,111,238,349,104,58,28,54,145,573
77,Jalen Brunson\brunsja01,PG,24,DAL,68,12,1697,328,627,0.5231259968102073,81,200,0.405,247,427,0.5784543325526932,0.5877192982456141,120,151,0.7947019867549668,27,204,231,239,35,1,80,109,857
81,Trey Burke\burketr01,PG,28,DAL,62,1,911,151,353,0.42776203966005666,58,164,0.35365853658536583,93,189,0.49206349206349204,0.509915014164306,51,57,0.8947368421052632,10,44,54,81,36,7,33,64,411
87,Facundo Campazzo\campafa01,PG,29,DEN,65,19,1425,120,315,0.38095238095238093,76,216,0.35185185185185186,44,99,0.4444444444444444,0.5015873015873016,80,91,0.8791208791208791,22,112,134,232,79,14,73,132,396
89,Devin Cannady\cannade01,PG,24,ORL,8,0,74,11,28,0.39285714285714285,6,16,0.375,5,12,0.4166666666666667,0.5,6,7,0.8571428571428571,0,5,5,1,5,1,2,9,34
92,Jevon Carter\carteje01,PG,25,PHO,60,1,717,94,223,0.42152466367713004,56,151,0.3708609271523179,38,72,0.5277777777777778,0.547085201793722,4,7,0.5714285714285714,16,76,92,71,29,9,16,56,248
95,Alex Caruso\carusal01,PG,26,LAL,58,6,1216,133,305,0.4360655737704918,55,137,0.40145985401459855,78,168,0.4642857142857143,0.5262295081967213,49,76,0.6447368421052632,31,139,170,160,64,15,76,108,370
97,Chris Chiozza\chiozch01,PG,25,BRK,22,1,232,31,88,0.3522727272727273,13,42,0.30952380952380953,18,46,0.391304347826087,0.42613636363636365,13,17,0.7647058823529411,3,21,24,65,7,6,16,19,88
105,Mike Conley\conlemi01,PG,33,UTA,51,51,1498,284,640,0.44375,138,335,0.41194029850746267,146,305,0.4786885245901639,0.5515625,121,142,0.852112676056338,36,141,177,305,70,9,99,98,827
107,Quinn Cook\cookqu01,PG,27,TOT,46,0,314,58,136,0.4264705882352941,22,52,0.4230769230769231,36,84,0.42857142857142855,0.5073529411764706,14,16,0.875,4,30,34,36,8,2,14,20,152
115,Stephen Curry\curryst01,PG,32,GSW,63,63,2152,658,1365,0.48205128205128206,337,801,0.4207240948813982,321,564,0.5691489361702128,0.6054945054945055,362,395,0.9164556962025316,29,316,345,363,77,8,213,119,2015
122,Matthew Dellavedova\dellama01,PG,30,CLE,13,1,224,14,56,0.25,4,25,0.16,10,31,0.3225806451612903,0.2857142857142857,4,4,1.0,6,18,24,58,4,1,6,21,36
129,Luka Dončić\doncilu01,PG,21,DAL,66,66,2262,647,1351,0.4789045151739452,192,548,0.35036496350364965,455,803,0.5666251556662516,0.5499629903774982,344,471,0.7303609341825902,54,473,527,567,64,36,281,152,1830
132,Devon Dotson\dotsode01,PG,21,CHI,11,0,50,11,21,0.5238095238095238,1,7,0.14285714285714285,10,14,0.7142857142857143,0.5476190476190477,0,0,nan,2,3,5,7,4,0,0,3,23
135,Goran Dragić\dragigo01,PG,34,MIA,50,11,1337,240,555,0.43243243243243246,91,244,0.3729508196721312,149,311,0.4790996784565916,0.5144144144144144,101,122,0.8278688524590164,25,144,169,219,33,8,118,113,672
138,Kris Dunn\dunnkr01,PG,26,ATL,4,0,45,1,12,0.08333333333333333,0,2,0.0,1,10,0.1,0.08333333333333333,3,4,0.75,0,6,6,2,2,2,3,10,5
154,Yogi Ferrell\ferreyo01,PG,27,TOT,20,0,272,40,114,0.3508771929824561,18,56,0.32142857142857145,22,58,0.3793103448275862,0.4298245614035088,14,18,0.7777777777777778,10,28,38,44,14,6,6,22,112
157,Malachi Flynn\flynnma01,PG,22,TOR,47,14,928,127,340,0.3735294117647059,54,168,0.32142857142857145,73,172,0.42441860465116277,0.45294117647058824,45,56,0.8035714285714286,10,106,116,137,38,7,43,68,353
159,Trent Forrest\forretr01,PG,22,UTA,30,0,302,32,71,0.4507042253521127,5,26,0.19230769230769232,27,45,0.6,0.4859154929577465,19,19,1.0,11,33,44,45,9,4,21,22,88
161,De'Aaron Fox\foxde01,PG,23,SAC,58,58,2036,529,1110,0.4765765765765766,103,320,0.321875,426,790,0.5392405063291139,0.522972972972973,300,417,0.7194244604316546,33,170,203,417,87,27,174,170,1461
163,Tim Frazier\fraziti01,PG,30,MEM,5,0,62,3,20,0.15,0,8,0.0,3,12,0.25,0.15,2,6,0.3333333333333333,0,8,8,16,2,1,4,7,8
165,Markelle Fultz\fultzma01,PG,22,ORL,8,8,215,41,104,0.3942307692307692,4,16,0.25,37,88,0.42045454545454547,0.41346153846153844,17,19,0.8947368421052632,5,20,25,43,8,2,18,18,103
170,Darius Garland\garlada01,PG,21,CLE,54,50,1790,362,802,0.4513715710723192,105,266,0.39473684210526316,257,536,0.47947761194029853,0.5168329177057357,112,132,0.8484848484848485,23,106,129,329,66,6,164,110,941
180,Brandon Goodwin\goodwbr01,PG,25,ATL,47,5,620,84,223,0.37668161434977576,32,103,0.3106796116504854,52,120,0.43333333333333335,0.4484304932735426,28,43,0.6511627906976745,8,61,69,95,17,0,36,41,228
183,Devonte' Graham\grahade01,PG,25,CHO,55,44,1659,252,669,0.37668161434977576,179,477,0.3752620545073375,73,192,0.3802083333333333,0.5104633781763827,133,158,0.8417721518987342,22,126,148,295,48,6,84,77,816
192,Kyle Guy\guyky01,PG,23,SAC,31,0,235,29,88,0.32954545454545453,13,46,0.2826086956521739,16,42,0.38095238095238093,0.4034090909090909,16,20,0.8,5,30,35,32,6,0,11,20,87
194,Ashton Hagans\haganas01,PG,21,MIN,2,0,4,0,0,nan,0,0,nan,0,0,nan,nan,0,0,nan,0,0,0,0,0,0,1,0,0
195,Tyrese Haliburton\halibty01,PG,20,SAC,58,20,1746,292,619,0.4717285945072698,121,296,0.40878378378378377,171,323,0.5294117647058824,0.5694668820678513,48,56,0.8571428571428571,39,134,173,309,77,28,92,83,753
202,Jared Harper\harpeja01,PG,23,NYK,8,0,16,0,4,0.0,0,1,0.0,0,3,0.0,0.0,3,4,0.75,0,2,2,1,0,0,3,1,3
213,Killian Hayes\hayeski01,PG,19,DET,26,18,670,71,201,0.35323383084577115,20,72,0.2777777777777778,51,129,0.3953488372093023,0.40298507462686567,14,17,0.8235294117647058,6,63,69,138,27,10,83,57,176
219,George Hill\hillge01,PG,34,TOT,60,34,1344,190,394,0.48223350253807107,62,160,0.3875,128,234,0.5470085470085471,0.5609137055837563,80,100,0.8,32,90,122,146,46,10,62,62,522
223,Aaron Holiday\holidaa01,PG,24,IND,66,8,1176,170,436,0.38990825688073394,67,182,0.36813186813186816,103,254,0.40551181102362205,0.46674311926605505,68,83,0.8192771084337349,15,74,89,123,46,13,66,94,475
224,Jrue Holiday\holidjr01,PG,30,MIL,59,56,1907,414,823,0.503037667071689,111,283,0.392226148409894,303,540,0.5611111111111111,0.5704738760631834,107,136,0.7867647058823529,73,195,268,357,96,37,127,98,1046
243,Kyrie Irving\irvinky01,PG,28,BRK,54,54,1886,549,1086,0.505524861878453,152,378,0.4021164021164021,397,708,0.5607344632768362,0.5755064456721916,201,218,0.9220183486238532,52,205,257,324,76,37,130,140,1451
245,Frank Jackson\jacksfr01,PG,22,DET,40,6,738,134,293,0.45733788395904434,61,150,0.4066666666666667,73,143,0.5104895104895105,0.5614334470989761,61,75,0.8133333333333334,15,71,86,36,15,1,34,53,390
251,LeBron James\jamesle01,PG,36,LAL,45,45,1504,422,823,0.5127582017010935,104,285,0.3649122807017544,318,538,0.5910780669144982,0.5759416767922235,178,255,0.6980392156862745,29,317,346,350,48,25,168,70,1126
252,Mike James\jamesmi02,PG,30,BRK,13,1,236,34,92,0.3695652173913043,11,31,0.3548387096774194,23,61,0.3770491803278688,0.42934782608695654,21,27,0.7777777777777778,3,29,32,54,6,1,20,10,100
266,Tre Jones\jonestr01,PG,21,SAS,37,1,269,37,78,0.47435897435897434,3,5,0.6,34,73,0.4657534246575342,0.4935897435897436,17,19,0.8947368421052632,8,13,21,39,8,0,13,13,94
267,Tyus Jones\jonesty01,PG,24,MEM,70,9,1222,178,413,0.43099273607748184,45,140,0.32142857142857145,133,273,0.48717948717948717,0.4854721549636804,41,45,0.9111111111111111,21,119,140,259,64,6,48,31,442
269,Cory Joseph\josepco01,PG,29,TOT,126,26,2892,400,852,0.4694835680751174,90,264,0.3409090909090909,310,588,0.5272108843537415,0.5223004694835681,144,176,0.8181818181818182,70,248,318,426,122,36,158,278,1034
288,Jalen Lecque\lecquja01,PG,20,IND,4,0,12,1,9,0.1111111111111111,0,1,0.0,1,8,0.125,0.1111111111111111,3,3,1.0,2,3,5,2,0,0,0,0,5
290,Saben Lee\leesa01,PG,21,DET,48,7,781,99,210,0.4714285714285714,8,23,0.34782608695652173,91,187,0.48663101604278075,0.49047619047619045,61,89,0.6853932584269663,20,77,97,174,32,13,55,76,267
295,Kira Lewis Jr.\lewiski01,PG,19,NOP,54,0,904,130,337,0.3857566765578635,40,120,0.3333333333333333,90,217,0.4147465437788018,0.44510385756676557,43,51,0.8431372549019608,12,59,71,124,38,10,34,88,343
296,Damian Lillard\lillada01,PG,30,POR,67,67,2398,602,1334,0.4512743628185907,275,704,0.390625,327,630,0.5190476190476191,0.5543478260869565,449,484,0.9276859504132231,32,251,283,505,62,17,203,102,1928
303,Kyle Lowry\lowryky01,PG,34,TOR,46,46,1601,260,596,0.436241610738255,131,331,0.3957703927492447,129,265,0.4867924528301887,0.5461409395973155,140,160,0.875,35,212,247,338,45,14,126,143,791
308,Théo Maledon\maledth01,PG,19,OKC,65,49,1778,226,614,0.36807817589576547,105,313,0.3354632587859425,121,301,0.4019933554817276,0.4535830618892508,101,135,0.7481481481481481,25,186,211,227,56,11,141,126,658
309,Karim Mané\maneka01,PG,20,ORL,10,0,88,3,13,0.23076923076923078,1,2,0.5,2,11,0.18181818181818182,0.2692307692307692,4,5,0.8,1,13,14,4,0,2,3,10,11
311,Nico Mannion\mannini01,PG,19,GSW,30,1,364,39,114,0.34210526315789475,22,60,0.36666666666666664,17,54,0.3148148148148148,0.43859649122807015,23,28,0.8214285714285714,6,40,46,70,16,1,31,29,123
317,Jeremiah Martin\martije02,PG,24,CLE,9,0,75,9,33,0.2727272727272727,3,12,0.25,6,21,0.2857142857142857,0.3181818181818182,1,5,0.2,2,5,7,4,5,2,6,1,22
320,Frank Mason III\masonfr01,PG,26,ORL,4,1,79,9,24,0.375,2,5,0.4,7,19,0.3684210526315789,0.4166666666666667,5,7,0.7142857142857143,3,9,12,12,0,0,5,7,25
328,T.J. McConnell\mccontj01,PG,28,IND,69,3,1796,274,490,0.5591836734693878,15,48,0.3125,259,442,0.5859728506787331,0.5744897959183674,33,48,0.6875,55,201,256,456,128,23,135,113,596
336,Jordan McLaughlin\mclaujo01,PG,24,MIN,51,2,938,100,242,0.4132231404958678,33,92,0.358695652173913,67,150,0.44666666666666666,0.48140495867768596,23,30,0.7666666666666667,21,87,108,193,51,6,51,44,256
339,De'Anthony Melton\meltode01,PG,22,MEM,52,1,1045,172,393,0.43765903307888043,87,211,0.41232227488151657,85,182,0.46703296703296704,0.5483460559796438,41,51,0.803921568627451,30,131,161,132,60,31,66,85,472
344,Patty Mills\millspa02,PG,32,SAS,68,1,1685,252,611,0.41243862520458263,161,429,0.3752913752913753,91,182,0.5,0.544189852700491,71,78,0.9102564102564102,18,98,116,162,42,3,66,81,736
347,Donovan Mitchell\mitchdo01,PG,24,UTA,53,53,1771,478,1091,0.4381301558203483,178,461,0.38611713665943603,300,630,0.47619047619047616,0.5197066911090742,267,316,0.8449367088607594,50,185,235,277,52,15,147,117,1401
351,Ja Morant\moranja01,PG,21,MEM,63,63,2053,430,957,0.44932079414838033,73,241,0.3029045643153527,357,716,0.49860335195530725,0.48746081504702193,271,372,0.728494623655914,59,193,252,465,57,13,203,87,1204
355,Monte Morris\morrimo01,PG,25,DEN,47,13,1196,186,387,0.4806201550387597,51,134,0.3805970149253731,135,253,0.5335968379446641,0.5465116279069767,58,73,0.7945205479452054,11,85,96,150,34,13,34,48,481
356,Mychal Mulder\muldemy01,PG,26,GSW,60,6,766,119,265,0.4490566037735849,85,214,0.397196261682243,34,51,0.6666666666666666,0.6094339622641509,14,22,0.6363636363636364,8,52,60,26,12,12,16,56,337
357,Dejounte Murray\murrade01,PG,24,SAS,67,67,2139,441,974,0.4527720739219713,63,199,0.3165829145728643,378,775,0.48774193548387096,0.4851129363449692,106,134,0.7910447761194029,58,415,473,363,101,7,117,135,1051
358,Jamal Murray\murraja01,PG,23,DEN,48,48,1704,378,792,0.4772727272727273,129,316,0.40822784810126583,249,476,0.523109243697479,0.5587121212121212,133,153,0.869281045751634,37,157,194,231,64,13,108,95,1018
364,Raul Neto\netora01,PG,28,WAS,64,22,1403,209,447,0.46756152125279643,64,164,0.3902439024390244,145,283,0.5123674911660777,0.5391498881431768,75,85,0.8823529411764706,28,128,156,146,73,6,53,109,557
369,Frank Ntilikina\ntilila01,PG,22,NYK,33,4,322,29,79,0.3670886075949367,23,48,0.4791666666666667,6,31,0.1935483870967742,0.5126582278481012,8,18,0.4444444444444444,6,25,31,19,18,4,11,45,89
370,Kendrick Nunn\nunnke01,PG,25,MIA,56,44,1650,319,658,0.4848024316109423,122,320,0.38125,197,338,0.5828402366863905,0.5775075987841946,56,60,0.9333333333333333,21,158,179,148,52,14,80,108,816
395,Chris Paul\paulch01,PG,35,PHO,70,70,2199,439,879,0.49943117178612056,102,258,0.3953488372093023,337,621,0.5426731078904992,0.5574516496018203,169,181,0.9337016574585635,25,287,312,622,99,19,156,166,1149
396,Cameron Payne\payneca01,PG,26,PHO,60,1,1079,191,395,0.4835443037974684,73,166,0.4397590361445783,118,229,0.5152838427947598,0.5759493670886076,50,56,0.8928571428571429,16,128,144,217,36,16,60,97,505
397,Elfrid Payton\paytoel01,PG,26,NYK,63,63,1484,269,622,0.432475884244373,28,98,0.2857142857142857,241,524,0.4599236641221374,0.454983922829582,73,107,0.6822429906542056,64,152,216,203,47,9,103,116,639
398,Gary Payton II\paytoga02,PG,28,GSW,10,0,40,10,13,0.7692307692307693,2,4,0.5,8,9,0.8888888888888888,0.8461538461538461,3,4,0.75,2,9,11,1,6,1,1,8,25
417,Immanuel Quickley\quickim01,PG,21,NYK,64,3,1243,229,580,0.39482758620689656,118,303,0.38943894389438943,111,277,0.4007220216606498,0.496551724137931,155,174,0.8908045977011494,25,112,137,127,30,12,58,114,731
419,Chasson Randle\randlch01,PG,27,ORL,41,5,837,92,237,0.3881856540084388,44,130,0.3384615384615385,48,107,0.4485981308411215,0.4810126582278481,38,48,0.7916666666666666,7,75,82,74,22,5,46,64,266
428,Grant Riller\rillegr01,PG,23,CHO,7,0,27,8,12,0.6666666666666666,2,4,0.5,6,8,0.75,0.75,0,0,nan,0,1,1,3,1,0,1,0,18
434,Justin Robinson\robinju01,PG,23,OKC,9,0,88,7,21,0.3333333333333333,4,14,0.2857142857142857,3,7,0.42857142857142855,0.42857142857142855,3,5,0.6,1,6,7,9,3,0,2,10,21
437,Rajon Rondo\rondora01,PG,34,TOT,90,6,1540,190,430,0.4418604651162791,72,178,0.4044943820224719,118,252,0.46825396825396826,0.5255813953488372,32,34,0.9411764705882353,36,184,220,398,74,8,158,106,484
438,Derrick Rose\rosede01,PG,32,TOT,100,6,2558,574,1222,0.469721767594108,100,258,0.3875968992248062,474,964,0.491701244813278,0.5106382978723404,220,254,0.8661417322834646,40,220,260,418,98,38,156,112,1468
441,Ricky Rubio\rubiori01,PG,30,MIN,68,51,1772,193,498,0.38755020080321284,66,214,0.308411214953271,127,284,0.4471830985915493,0.4538152610441767,130,150,0.8666666666666667,28,195,223,433,98,4,111,139,582
442,D'Angelo Russell\russeda01,PG,24,MIN,42,26,1196,281,652,0.43098159509202455,120,310,0.3870967741935484,161,342,0.47076023391812866,0.5230061349693251,114,149,0.7651006711409396,16,95,111,244,45,18,112,68,796
456,Ben Simmons\simmobe01,PG,24,PHI,58,58,1877,325,583,0.5574614065180102,3,10,0.3,322,573,0.5619546247818499,0.5600343053173242,176,287,0.6132404181184669,93,324,417,401,93,35,173,171,829
460,Marcus Smart\smartma01,PG,26,BOS,48,45,1581,203,510,0.3980392156862745,93,282,0.32978723404255317,110,228,0.4824561403508772,0.4892156862745098,128,162,0.7901234567901234,36,131,167,273,72,23,96,126,627
461,Dennis Smith Jr.\smithde03,PG,23,TOT,46,18,840,116,290,0.4,38,116,0.3275862068965517,78,174,0.4482758620689655,0.46551724137931033,38,52,0.7307692307692307,24,86,110,154,46,28,52,74,308
462,Ish Smith\smithis01,PG,32,WAS,44,1,924,129,297,0.43434343434343436,18,49,0.3673469387755102,111,248,0.4475806451612903,0.46464646464646464,19,33,0.5757575757575758,22,128,150,172,32,13,41,62,295
473,Jeff Teague\teaguje01,PG,32,TOT,110,14,1900,246,568,0.43309859154929575,72,164,0.43902439024390244,174,404,0.4306930693069307,0.4964788732394366,178,210,0.8476190476190476,30,146,176,264,68,24,128,112,742
475,Tyrell Terry\terryty01,PG,20,DAL,11,0,56,5,16,0.3125,0,7,0.0,5,9,0.5555555555555556,0.3125,1,3,0.3333333333333333,0,6,6,6,5,0,2,2,11
478,Isaiah Thomas\thomais02,PG,31,NOP,3,0,48,9,27,0.3333333333333333,3,12,0.25,6,15,0.4,0.3888888888888889,2,2,1.0,1,3,4,5,1,0,6,3,23
493,Rayjon Tucker\tuckera01,PG,23,PHI,14,0,68,9,18,0.5,2,7,0.2857142857142857,7,11,0.6363636363636364,0.5555555555555556,14,19,0.7368421052631579,1,10,11,6,2,0,4,8,34
501,Gabe Vincent\vincega01,PG,24,MIA,50,7,655,88,233,0.3776824034334764,46,149,0.3087248322147651,42,84,0.5,0.47639484978540775,20,23,0.8695652173913043,10,46,56,67,21,2,34,79,242
506,Kemba Walker\walkeke02,PG,30,BOS,43,43,1369,284,676,0.42011834319526625,127,353,0.3597733711048159,157,323,0.48606811145510836,0.5140532544378699,134,149,0.8993288590604027,16,154,170,212,48,12,88,61,829
508,John Wall\walljo01,PG,30,HOU,40,40,1288,293,726,0.4035812672176309,79,249,0.3172690763052209,214,477,0.44863731656184486,0.45798898071625344,158,211,0.7488151658767772,17,112,129,275,42,31,141,46,823
509,Brad Wanamaker\wanambr01,PG,31,TOT,122,0,2106,230,598,0.38461538461538464,32,170,0.18823529411764706,198,428,0.46261682242990654,0.411371237458194,180,202,0.8910891089108911,36,174,210,348,86,22,142,188,672
513,Tremont Waters\watertr01,PG,23,BOS,26,3,238,34,84,0.40476190476190477,15,38,0.39473684210526316,19,46,0.41304347826086957,0.49404761904761907,16,17,0.9411764705882353,5,16,21,62,15,1,27,17,99
516,Russell Westbrook\westbru01,PG,32,WAS,65,65,2369,544,1238,0.4394184168012924,86,273,0.315018315018315,458,965,0.47461139896373056,0.47415185783521807,271,413,0.6561743341404358,109,641,750,763,89,23,312,190,1445
517,Coby White\whiteco01,PG,20,CHI,69,54,2156,375,902,0.4157427937915743,163,454,0.3590308370044053,212,448,0.4732142857142857,0.5060975609756098,128,142,0.9014084507042254,28,256,284,328,38,15,156,179,1041
524,Lou Williams\willilo02,PG,34,TOT,132,8,2846,530,1292,0.4102167182662539,138,346,0.3988439306358382,392,946,0.4143763213530655,0.46362229102167185,300,346,0.8670520231213873,42,234,276,450,94,12,216,124,1498
531,Cassius Winston\winstca01,PG,22,WAS,22,0,98,14,33,0.42424242424242425,8,17,0.47058823529411764,6,16,0.375,0.5454545454545454,5,6,0.8333333333333334,0,9,9,12,2,1,5,8,41
537,Trae Young\youngtr01,PG,22,ATL,63,63,2125,487,1112,0.4379496402877698,136,397,0.3425692695214106,351,715,0.4909090909090909,0.49910071942446044,484,546,0.8864468864468864,38,207,245,594,53,12,261,111,1594
